7,7,7,7,7,7,7,7,7,7,7,7,7,7,7,7,7,7,7,7,6,6,6,6,6,6,6,6,6,6,6,6,6,6,6,6,6,6,6,6,6,6,6,6,6,6,6,6,6,6,6,6,6,6,6,6,6,5,3,3,3,3,3,3,3,3,3,3,3,3,3,3,3,3,3,3,3,3,3,3,3,3,3,3,3,3,3,3,3,3,3,3,3,3,3,3,3,3,3,3,3,3,3,3,4,4,4,3,3,3,3,3,3,5,5,4,5,5,0,6,6,0,0,0,0,0,0,0
7,7,7,7,7,7,7,7,7,7,7,7,7,7,7,7,7,7,7,7,7,6,6,6,6,6,6,6,6,6,6,6,6,6,6,6,6,6,6,6,6,6,6,6,6,6,6,6,6,6,5,6,6,6,6,6,6,5,3,3,3,3,3,3,3,3,3,4,4,4,3,3,3,3,3,3,3,3,3,3,3,3,4,3,3,3,3,3,3,3,4,3,3,3,3,3,3,3,3,3,3,3,4,3,5,4,4,3,3,3,3,3,3,5,6,4,4,5,0,6,6,0,0,0,0,0,0,0
7,7,7,7,7,7,7,7,7,7,7,7,7,7,7,7,7,7,7,7,7,7,7,7,7,6,6,6,6,6,6,6,6,6,6,6,6,6,6,6,6,6,6,6,6,6,6,6,6,6,5,5,6,6,6,6,6,5,5,4,3,3,3,3,3,3,3,4,4,4,3,3,3,3,3,3,3,3,3,3,3,4,4,3,3,3,3,3,3,3,3,4,4,3,3,3,3,3,3,3,3,4,4,4,4,5,5,4,4,3,3,3,5,6,6,4,4,6,0,6,6,6,0,0,0,0,0,0
7,7,7,7,7,7,7,7,7,7,7,7,7,7,7,7,7,7,7,7,7,7,7,7,7,7,7,6,6,6,6,6,6,6,6,6,6,6,6,6,6,6,6,6,6,6,6,6,5,6,6,6,6,6,6,6,6,6,6,5,3,3,3,3,3,3,3,4,3,3,3,3,3,3,3,3,3,3,3,3,3,4,3,3,3,3,3,3,3,3,3,4,4,4,4,4,3,3,3,3,4,5,5,5,5,5,5,5,4,4,4,5,6,6,6,5,5,6,0,6,7,7,0,0,0,0,0,0
7,7,7,7,7,7,7,7,7,7,7,7,7,7,7,7,7,7,7,7,7,7,7,7,7,7,7,7,6,6,6,6,6,6,6,6,6,6,6,6,6,6,6,6,6,6,6,6,6,6,6,6,6,6,6,6,6,6,6,5,5,3,3,3,3,3,3,4,5,3,3,3,3,3,3,3,3,3,3,3,4,4,3,3,3,3,3,3,3,4,4,4,5,5,5,4,3,3,3,4,5,5,5,5,5,4,5,5,6,6,6,6,6,6,5,4,5,6,0,7,0,0,0,0,0,0,0,0
7,7,7,7,7,7,7,7,7,7,7,7,7,7,7,7,7,7,7,7,7,7,7,7,7,7,7,7,7,6,6,6,6,6,6,7,7,7,6,6,6,6,6,6,6,6,6,6,6,6,6,6,6,6,6,6,6,6,6,6,6,6,5,3,3,3,3,6,6,4,3,3,3,3,3,3,3,3,3,3,4,3,3,3,3,3,3,3,4,4,4,5,5,5,5,4,3,3,4,5,6,6,6,6,5,4,3,6,6,6,6,6,6,6,5,5,6,0,0,7,0,0,0,0,0,0,0,0
8,8,8,7,7,7,8,8,7,7,8,8,8,8,8,7,7,7,7,7,7,7,7,7,7,7,7,7,7,7,7,7,7,7,7,7,7,7,7,6,6,6,6,6,6,6,6,6,6,6,6,6,6,6,7,6,5,5,5,5,4,6,7,6,4,3,3,5,5,5,4,3,3,2,3,3,3,3,4,4,3,3,3,3,3,3,3,4,4,4,5,5,5,5,5,4,3,4,5,6,6,6,6,6,6,5,3,6,6,6,6,6,6,6,5,6,6,0,0,7,0,0,0,0,0,0,0,0
8,8,8,8,7,8,8,8,8,8,0,0,8,8,8,8,7,7,8,8,8,8,7,7,0,0,7,7,7,7,7,7,7,7,7,7,7,7,7,7,7,7,7,7,7,6,7,7,7,7,7,7,7,7,7,7,7,7,5,4,4,6,7,7,5,5,3,3,3,5,3,3,3,3,3,3,3,3,3,4,4,4,4,3,3,4,5,5,5,5,6,5,6,5,4,4,4,5,6,6,6,6,6,6,6,5,5,6,6,6,6,6,6,6,6,6,0,0,0,7,7,0,0,0,0,0,0,0
8,8,8,0,8,8,8,0,0,0,0,8,8,8,8,8,8,8,8,8,8,8,0,0,0,0,7,7,7,7,7,7,7,7,7,7,7,7,7,7,7,7,7,7,7,7,7,7,7,7,7,7,7,7,7,6,7,6,6,6,8,8,7,7,6,6,5,3,3,3,5,3,3,3,3,4,3,4,5,5,5,5,5,5,4,5,6,6,6,6,5,5,6,5,5,5,5,6,6,7,6,6,6,6,6,6,5,6,6,6,6,6,6,6,6,6,0,0,0,7,0,0,0,0,0,0,0,0
8,8,0,0,0,8,8,0,0,0,9,9,9,8,8,8,8,8,8,8,8,0,0,0,0,0,8,8,7,7,7,7,7,7,7,7,7,7,7,7,7,7,7,7,7,7,7,7,8,8,8,8,7,6,5,3,6,5,6,7,7,8,8,8,6,6,6,6,5,4,4,3,3,3,4,6,6,6,6,6,6,6,6,6,6,6,6,6,6,6,5,4,6,4,6,6,5,6,7,7,7,6,6,6,6,6,5,6,6,7,7,6,6,6,6,0,0,0,0,0,0,0,0,0,0,0,0,7
8,8,0,0,0,0,8,8,0,9,9,9,9,8,8,8,8,8,8,8,0,0,0,0,8,8,8,8,8,7,7,7,7,7,7,8,8,8,8,8,8,8,8,8,8,8,8,8,8,8,8,8,7,3,3,3,6,7,8,8,8,8,8,8,7,7,6,7,7,7,4,5,4,4,4,4,5,5,6,6,6,6,6,6,6,6,6,6,6,6,6,6,6,6,5,6,6,7,7,7,7,6,6,6,6,6,6,6,6,7,7,6,6,6,0,0,0,0,0,8,0,0,0,0,0,7,0,0
8,0,0,0,0,0,0,0,0,0,0,9,7,7,6,7,8,8,8,9,0,0,0,8,8,8,8,8,8,8,8,7,8,8,8,8,8,8,8,8,8,7,7,8,8,8,8,8,8,8,8,8,8,8,8,6,4,5,4,5,5,6,6,4,7,6,6,6,4,8,8,7,6,6,6,6,6,6,6,6,6,6,6,6,6,6,6,6,6,6,6,6,6,5,6,6,7,7,7,7,7,7,6,6,6,6,6,6,7,7,7,7,7,0,0,0,0,0,0,8,7,0,0,8,0,0,0,0
0,0,0,0,0,0,0,0,0,0,0,0,9,6,4,3,7,8,8,9,0,0,0,0,8,8,8,8,8,8,8,8,8,8,8,8,8,8,8,8,8,8,8,7,8,8,8,8,8,7,7,6,6,7,7,5,7,6,3,3,3,3,5,6,6,6,7,6,3,4,8,6,6,6,7,6,6,6,6,6,6,6,6,6,6,6,6,6,6,6,6,6,6,6,6,7,7,7,7,7,7,7,6,6,6,6,6,7,7,7,7,7,0,0,0,0,0,0,0,8,7,7,8,0,0,0,0,0
0,0,0,0,0,0,0,0,0,0,0,0,0,0,9,6,5,5,5,5,7,0,0,0,0,0,9,9,8,8,8,8,8,8,8,8,8,8,8,9,9,9,9,7,6,6,5,4,5,6,6,6,5,4,3,3,4,3,5,4,4,4,5,9,9,9,9,9,9,7,6,6,7,6,7,7,7,6,6,7,7,7,7,7,6,6,6,6,6,6,6,6,6,6,6,7,7,7,7,7,7,7,7,6,6,6,7,8,0,7,7,0,0,0,0,0,0,8,8,8,8,0,0,0,0,0,0,0
0,0,0,0,0,0,0,0,0,0,0,0,0,0,10,7,7,7,7,5,5,0,0,0,0,0,9,9,9,9,9,9,8,8,8,9,9,9,9,9,9,9,9,8,5,5,6,5,4,4,5,3,3,3,2,4,6,8,8,8,8,8,7,8,8,8,8,8,8,7,6,6,6,7,7,7,7,7,7,7,7,7,7,6,6,6,6,6,6,6,6,6,6,6,6,7,7,7,8,8,8,7,7,6,5,3,7,0,0,0,0,0,0,0,0,0,0,9,0,0,8,0,0,0,0,0,0,0
10,0,0,0,9,8,8,9,9,0,0,0,0,0,8,7,7,9,9,9,5,7,0,0,0,0,0,9,9,9,9,9,9,9,9,9,9,9,9,9,9,9,9,8,6,9,7,6,6,6,4,3,3,7,8,8,9,9,9,9,9,9,7,8,8,8,9,8,8,7,6,6,6,7,7,7,7,7,7,7,7,7,7,7,7,6,6,6,6,6,6,6,6,6,7,7,7,8,9,8,7,7,7,6,4,4,7,0,0,0,0,0,0,0,0,0,0,0,9,0,0,0,0,0,0,0,0,0
0,10,9,9,8,8,9,9,9,8,8,9,8,7,7,7,7,7,7,9,9,9,9,0,0,0,9,9,9,9,9,9,9,9,9,9,9,9,9,9,9,9,9,9,9,9,9,6,3,3,4,6,6,7,9,9,9,9,9,9,9,9,9,9,9,9,9,9,8,8,8,7,7,8,7,8,8,8,7,8,8,8,7,7,7,7,7,7,7,7,7,7,7,7,8,8,8,0,0,8,8,8,7,6,6,7,0,0,0,0,0,0,0,0,0,0,0,9,8,0,0,0,0,0,0,0,0,0
9,9,9,9,9,9,9,8,8,8,9,8,8,7,7,7,7,9,7,9,10,10,0,0,0,0,9,9,10,10,10,9,9,9,9,9,9,9,9,9,9,7,7,6,6,4,4,3,4,4,9,9,9,9,9,9,9,9,9,9,9,9,9,9,9,9,9,9,8,7,6,4,4,6,7,7,7,7,7,7,8,8,7,7,7,7,7,7,7,7,7,7,8,9,9,9,0,0,9,8,9,9,8,7,8,0,0,0,0,0,0,0,0,0,0,0,0,9,8,0,0,0,0,0,0,0,0,0
9,9,9,9,9,9,9,8,8,8,9,9,9,8,8,8,7,9,9,9,9,10,0,0,0,0,0,10,10,10,10,10,10,10,10,10,10,10,10,10,9,7,7,6,6,4,3,3,3,5,9,9,9,9,9,9,9,9,9,9,9,9,8,7,6,6,5,5,5,4,3,3,2,3,3,6,6,7,7,7,7,7,8,7,7,7,7,8,7,7,7,8,9,9,9,0,0,0,9,0,0,0,9,8,0,0,0,0,0,0,0,0,0,0,0,0,0,9,9,0,0,0,0,0,0,0,0,0
9,9,9,9,9,9,9,9,8,8,9,9,10,10,9,8,7,9,9,9,8,9,0,0,0,0,0,10,10,9,9,10,10,10,10,10,10,10,10,10,10,9,9,9,6,4,3,3,3,3,6,9,9,9,9,9,9,9,9,8,8,7,4,3,3,5,5,5,5,5,3,2,3,3,3,3,5,6,7,7,7,8,8,7,7,7,8,8,7,7,8,9,10,10,0,0,0,0,0,0,0,9,9,9,8,0,0,0,0,0,0,0,0,0,0,0,0,9,9,0,0,0,0,0,0,0,0,0
9,9,9,9,9,9,9,9,10,10,11,11,11,11,11,10,9,8,9,9,9,9,0,0,0,0,0,10,10,9,9,9,9,10,10,10,10,10,10,10,10,10,10,10,8,5,3,3,3,3,6,8,9,9,9,9,9,9,8,7,5,3,3,3,3,3,4,6,6,6,6,3,3,3,3,3,3,4,6,6,8,8,8,7,7,7,8,8,7,8,8,9,10,10,9,0,0,9,0,0,0,0,0,9,9,8,0,0,0,0,0,0,0,0,0,0,9,9,0,0,0,0,0,0,0,0,0,0
10,9,10,10,9,9,10,11,11,11,11,11,11,11,12,12,11,9,9,9,9,9,9,9,0,0,0,10,9,9,9,9,9,9,11,10,10,10,10,10,10,10,10,10,7,6,5,4,3,3,3,3,6,6,7,9,8,7,4,3,3,2,2,3,2,3,3,4,5,6,6,6,6,4,3,4,5,6,6,6,7,7,7,7,8,8,8,8,8,8,8,9,10,10,9,10,9,9,10,0,0,0,0,9,9,9,0,0,0,0,0,0,0,0,9,9,8,9,0,0,0,0,0,0,0,0,0,0
0,10,0,0,10,10,0,0,11,11,11,11,11,11,12,12,12,11,9,9,9,9,9,9,8,9,9,11,11,11,11,10,9,9,10,10,10,10,9,9,9,9,9,7,3,7,6,6,6,3,3,3,3,3,3,3,3,3,3,3,2,2,1,2,2,1,3,3,3,3,3,4,5,4,3,4,5,6,7,7,7,6,7,7,8,8,9,9,9,9,8,9,10,10,9,10,10,0,0,0,0,0,0,9,9,9,0,0,0,0,0,0,0,9,8,8,9,10,0,0,0,0,0,0,0,0,0,0
0,0,0,0,0,0,0,0,11,11,11,11,12,12,12,13,14,12,11,9,9,9,9,11,12,12,12,12,12,12,12,12,10,9,11,10,9,9,7,7,7,7,7,7,7,9,9,7,7,6,5,3,3,3,3,3,2,3,3,3,3,3,3,3,3,3,3,3,3,3,3,3,3,3,3,4,4,5,6,6,7,7,7,8,8,9,9,9,9,9,9,10,10,10,10,10,0,0,0,0,0,0,0,9,9,9,0,0,0,10,9,9,9,10,9,9,10,10,0,0,0,0,0,0,0,0,0,0
0,0,0,0,0,12,0,0,9,10,11,11,12,12,12,13,14,14,11,9,9,9,9,10,12,12,12,12,12,12,12,11,11,11,11,10,9,8,7,7,7,7,7,9,12,12,11,10,8,6,5,5,3,3,3,3,3,3,3,3,2,3,3,3,3,3,2,3,3,3,3,3,3,3,3,4,5,5,6,6,6,7,8,8,9,9,9,9,9,9,10,10,10,10,10,10,0,0,0,0,0,0,0,10,10,0,0,0,10,10,10,0,10,10,10,10,0,0,0,0,0,0,0,0,0,0,0,0
0,0,0,0,0,0,0,0,9,10,11,11,12,12,13,14,14,14,12,10,10,9,9,9,10,11,12,12,12,12,11,11,10,11,11,11,9,8,7,8,7,7,9,10,11,14,12,11,9,8,5,4,3,3,3,3,3,3,3,3,3,3,3,3,3,3,3,3,3,3,2,3,3,3,3,4,5,6,6,6,7,8,9,8,7,9,9,9,9,9,10,10,10,10,10,10,10,0,0,0,0,0,0,0,0,0,0,10,0,10,10,10,10,0,0,0,0,0,0,0,0,0,0,0,0,0,0,0
0,0,0,0,0,0,0,11,10,11,11,11,12,12,13,14,14,14,14,12,12,11,9,9,10,10,11,12,12,12,11,12,10,10,12,11,10,9,9,9,9,9,9,11,14,14,14,12,11,9,8,4,3,3,3,3,3,3,3,3,3,3,3,3,3,3,3,3,3,3,3,3,3,3,3,3,3,6,6,7,9,9,9,9,9,9,9,9,10,10,10,10,10,10,10,10,10,0,0,0,0,0,0,0,0,0,10,10,10,10,0,0,0,0,0,0,0,0,0,0,0,0,0,0,0,0,0,0
0,0,0,0,0,0,0,12,11,11,12,12,12,13,13,14,14,14,14,14,14,14,12,9,9,11,11,11,12,11,11,12,11,11,12,12,11,10,10,9,9,9,10,12,14,14,14,14,14,11,10,7,6,4,3,3,3,3,3,3,3,3,3,3,3,3,3,3,3,3,4,3,3,3,4,5,3,6,7,7,9,10,10,9,9,9,9,9,10,10,10,10,10,10,10,10,10,10,0,0,0,0,0,0,0,0,0,10,10,0,0,0,0,0,0,0,0,0,0,0,0,0,0,0,0,0,0,0
0,0,13,13,0,0,12,12,11,12,12,12,12,13,14,14,14,14,14,15,15,15,14,10,9,9,11,10,11,11,11,12,12,12,12,12,12,11,11,10,9,9,11,12,14,14,14,14,14,12,11,9,8,6,3,3,3,3,3,3,3,3,3,3,3,3,3,3,3,4,4,3,3,4,6,6,6,7,8,9,10,10,10,10,10,9,9,9,10,10,10,10,10,10,10,10,10,10,0,0,0,0,0,0,0,0,0,10,0,0,0,0,0,0,0,0,0,0,0,0,0,0,0,0,0,0,0,0
13,13,13,13,13,12,12,12,12,12,13,13,13,14,14,14,14,14,14,15,15,15,15,12,10,9,9,11,10,11,10,12,12,11,12,13,12,12,11,10,9,10,12,12,14,14,14,14,14,14,14,11,10,9,5,3,3,3,3,3,3,3,3,3,3,3,4,3,4,5,5,3,4,6,6,6,6,7,9,10,10,10,10,10,10,9,9,9,10,10,10,10,10,10,10,10,10,0,0,0,0,0,0,0,0,0,0,0,0,0,0,0,0,0,0,0,0,0,0,0,0,0,0,0,0,0,0,0
13,12,13,13,13,12,13,12,12,12,13,14,14,14,14,14,14,14,14,14,15,0,0,14,12,10,10,10,11,9,9,11,14,11,11,13,12,10,11,11,9,14,12,12,14,14,14,14,14,14,14,14,11,11,9,7,6,3,3,3,3,3,3,6,4,5,6,4,6,6,7,4,5,6,7,4,7,6,9,10,10,11,11,10,10,9,10,10,10,10,10,10,11,10,10,10,10,10,10,0,0,0,0,0,0,0,0,0,0,0,0,0,0,0,0,0,0,0,0,0,0,0,0,0,0,0,0,0
13,13,13,13,12,13,12,11,12,13,13,14,14,14,14,14,14,14,14,14,15,0,0,0,14,11,12,12,11,11,11,11,13,12,11,14,14,12,10,10,10,14,14,14,14,14,14,14,14,14,14,14,14,14,12,10,9,6,4,3,3,3,3,4,4,5,5,4,6,9,9,7,6,6,7,4,7,7,9,9,10,10,10,10,10,9,10,10,10,10,10,10,11,11,10,10,10,10,0,0,0,0,0,0,0,0,0,0,0,0,0,0,0,0,0,0,0,0,0,0,0,0,0,0,0,0,0,0
13,13,13,13,12,0,14,14,12,13,14,14,14,14,14,14,14,14,14,15,15,0,0,0,14,14,14,14,12,12,14,14,14,14,12,12,14,14,13,11,12,14,15,14,14,14,14,14,14,14,14,14,14,14,14,14,12,10,10,9,7,5,5,4,6,7,8,7,11,13,14,11,9,8,7,7,8,9,9,9,10,10,10,10,10,10,10,10,10,10,10,11,11,11,11,10,11,11,0,0,0,0,0,0,0,0,11,0,0,0,0,0,0,0,0,0,0,0,0,0,0,0,0,0,0,0,0,0
13,13,14,14,13,13,0,0,14,14,14,14,14,13,14,14,14,15,15,14,15,15,0,0,0,0,14,14,14,14,14,14,14,14,14,12,12,12,12,12,12,14,14,14,14,14,14,14,14,14,14,14,14,14,14,14,14,14,14,14,12,10,9,9,8,11,11,11,13,14,12,12,12,9,8,8,9,9,9,9,9,9,10,10,10,10,10,10,10,11,11,11,11,11,11,11,11,0,0,0,0,0,0,0,0,0,0,0,0,0,0,0,0,0,0,0,0,0,0,0,0,0,0,0,0,0,0,0
14,14,14,14,14,14,0,0,0,14,14,14,14,14,14,14,14,15,15,14,15,15,15,0,0,0,0,0,0,0,0,14,14,14,14,14,14,14,14,14,14,14,15,15,14,14,14,14,14,14,14,14,14,14,14,14,14,14,14,14,14,14,14,14,14,14,14,14,14,11,11,14,12,11,9,9,10,10,9,9,10,10,10,10,10,10,10,11,11,11,11,11,11,11,11,11,0,0,0,0,0,0,0,0,12,0,0,0,0,0,0,0,0,0,0,0,0,0,0,0,0,0,0,0,0,0,0,0
14,14,14,14,14,14,14,0,0,14,15,15,15,15,15,14,14,14,15,14,14,15,15,15,15,0,0,0,0,15,0,0,14,14,14,14,14,14,14,14,14,14,15,15,14,14,14,14,14,14,14,14,14,14,14,14,14,14,14,14,14,14,14,14,14,14,12,12,12,11,12,14,14,11,10,10,10,10,10,10,10,10,11,11,11,11,11,11,11,11,12,12,11,11,11,11,0,0,0,0,0,0,0,0,0,0,0,0,0,0,0,0,0,0,0,0,0,0,0,0,0,0,0,0,0,0,0,0
14,14,14,14,15,15,14,0,0,0,14,15,15,15,15,14,14,14,14,15,15,15,15,15,15,0,0,0,15,14,0,0,0,0,0,0,0,0,0,0,0,14,15,15,14,14,14,14,14,14,14,14,14,14,14,14,14,14,14,14,14,14,14,14,14,14,14,14,12,12,14,14,14,11,11,10,10,10,10,10,10,11,11,12,12,12,12,11,11,12,12,12,12,12,12,0,0,10,0,0,0,0,0,0,0,0,0,0,0,0,0,0,0,0,0,0,0,0,0,0,0,0,0,0,0,0,0,0
15,15,15,15,15,15,15,14,0,0,0,15,15,15,14,14,14,14,14,14,14,15,15,15,15,15,15,15,15,14,14,0,0,0,0,0,0,0,0,0,0,0,14,14,15,15,14,14,14,14,14,14,14,14,14,14,14,14,13,14,14,14,14,14,14,14,14,14,11,14,14,14,12,12,11,11,10,11,10,10,11,11,12,13,13,13,13,13,13,13,13,13,13,13,0,0,12,11,0,0,0,0,0,0,0,0,0,0,0,0,0,0,0,0,0,0,0,0,0,0,0,0,0,0,0,0,0,0
15,15,15,15,15,15,15,14,0,0,0,14,14,14,14,14,14,14,14,14,14,15,15,15,15,15,15,15,15,15,14,14,14,0,0,0,0,0,0,0,0,0,0,14,14,15,15,14,14,14,14,14,14,14,14,14,14,14,14,14,14,14,14,14,14,14,14,14,11,14,14,14,12,12,11,11,11,11,11,12,12,12,13,14,14,13,13,13,13,14,14,14,0,0,0,0,12,11,0,0,0,0,0,0,0,0,0,0,0,0,0,0,0,0,0,0,0,0,0,0,0,0,0,0,0,0,0,0
15,15,15,15,15,15,15,15,14,0,0,14,14,14,14,14,14,14,14,14,14,15,15,15,15,15,15,15,15,15,14,14,14,0,0,0,0,0,0,0,0,0,0,14,14,14,14,14,14,14,14,14,14,14,14,14,14,14,14,14,14,14,14,14,14,14,0,14,11,14,14,14,12,12,11,11,12,12,13,14,14,13,13,14,14,14,14,14,14,0,0,0,0,0,0,0,0,0,0,0,0,0,0,0,0,0,0,0,0,0,0,0,0,0,0,0,0,0,0,0,0,0,0,0,0,0,0,0
15,15,15,15,15,15,15,15,15,14,0,0,14,12,14,14,14,14,14,14,14,15,15,15,15,15,15,15,15,15,14,14,0,0,0,0,0,0,0,0,0,0,0,0,14,14,0,14,14,14,14,14,14,14,14,14,14,14,14,14,14,14,0,0,0,0,0,14,12,14,14,14,12,13,12,13,12,12,13,14,14,14,14,0,0,14,0,0,0,0,0,0,0,0,0,0,0,0,0,0,0,0,0,0,0,0,0,0,0,0,0,0,0,0,0,0,0,0,0,0,0,0,0,0,0,0,0,0
15,15,15,15,15,15,15,15,15,14,0,0,0,14,12,14,14,14,14,14,14,14,14,14,14,14,14,14,14,14,14,0,0,0,0,0,0,0,0,0,0,0,0,0,0,0,0,14,14,14,14,14,14,14,14,14,14,14,14,14,14,14,0,0,0,0,0,0,14,14,14,14,13,13,13,14,13,13,12,12,14,14,0,0,0,0,0,0,0,0,0,0,0,0,0,0,0,0,0,0,0,0,0,0,0,0,0,0,0,0,0,0,0,0,0,0,0,0,0,0,0,0,0,0,0,0,0,0
15,15,15,15,15,15,15,15,15,14,0,0,0,14,13,11,12,14,14,14,14,14,14,14,14,14,14,14,14,14,14,0,0,0,0,0,0,0,0,0,0,0,0,0,0,0,0,14,14,14,14,14,14,14,14,14,14,14,14,14,0,0,0,0,0,0,0,0,0,14,14,14,14,14,14,14,13,13,12,12,14,0,0,0,14,14,14,0,0,0,0,0,0,0,0,0,0,0,0,0,0,0,0,0,0,0,0,0,0,0,0,0,0,0,0,0,0,0,0,0,0,0,0,0,0,0,0,0
15,15,15,15,15,15,15,15,15,15,14,0,0,0,14,10,11,14,14,14,14,14,14,14,14,14,14,14,14,14,0,0,0,0,0,0,0,0,0,0,0,0,0,0,0,0,0,14,14,14,14,14,14,14,14,14,14,13,14,0,0,0,0,0,0,0,0,0,0,14,14,14,14,14,14,14,14,14,14,14,13,14,0,0,0,14,0,0,0,0,0,0,0,0,0,0,0,14,14,0,0,0,0,0,0,0,0,0,0,0,0,0,0,0,0,0,0,0,0,0,0,0,0,0,0,0,0,0
15,15,15,15,15,15,15,15,15,15,14,0,0,0,0,14,10,13,14,14,14,14,14,14,13,13,13,13,0,0,0,0,0,0,0,0,0,0,0,0,0,0,0,0,0,0,0,14,14,14,14,14,14,14,14,14,14,14,0,0,0,0,0,0,0,0,0,0,0,0,14,14,14,14,14,14,14,14,14,14,14,14,14,0,0,0,0,0,0,0,0,0,0,0,0,0,0,13,14,0,0,0,0,0,0,0,0,0,0,0,0,0,0,0,0,0,0,0,0,0,0,0,0,0,0,0,0,0
15,15,15,15,15,15,15,15,15,15,14,14,0,0,0,14,10,12,13,13,13,13,14,13,14,14,0,0,0,0,0,0,0,0,0,0,0,0,0,0,0,0,0,0,0,0,0,14,14,14,14,14,14,14,14,14,14,0,0,0,0,0,0,0,0,0,0,0,0,14,14,14,0,14,14,14,14,14,14,14,14,14,12,14,0,0,0,0,0,0,0,0,0,0,0,0,0,12,14,0,0,0,0,0,0,0,0,0,0,0,0,0,0,0,0,0,0,0,0,0,0,0,0,0,0,0,0,0
15,15,15,15,15,15,15,15,15,15,14,13,0,0,0,14,11,10,13,13,13,13,13,13,14,0,0,0,0,0,0,0,0,0,0,0,0,0,0,0,0,0,0,0,0,0,0,0,14,14,14,14,14,14,14,14,0,0,0,0,0,0,0,0,0,0,0,0,0,0,0,0,0,14,14,14,14,14,14,14,14,14,13,12,14,0,0,0,0,0,0,0,0,0,0,0,14,14,0,0,0,0,0,0,0,0,0,0,0,0,0,0,0,0,0,0,0,0,0,0,0,0,0,0,0,0,0,0
15,15,15,15,15,15,15,15,15,15,14,12,14,14,0,0,12,10,10,13,13,13,14,0,0,0,0,0,0,0,0,0,0,0,0,0,0,0,0,0,0,0,0,0,0,0,0,0,14,14,14,14,14,14,14,0,0,0,0,0,0,0,0,0,0,0,0,0,0,0,0,0,0,14,14,14,14,14,14,14,14,14,14,12,14,0,0,0,0,0,0,0,0,0,0,0,14,14,0,0,0,0,0,0,0,0,0,0,0,0,0,0,0,0,0,0,0,0,0,0,0,0,0,0,0,0,0,0
15,15,15,15,15,15,15,15,15,14,12,13,14,15,14,0,13,11,12,14,14,0,0,0,0,0,0,0,0,0,0,0,0,0,0,0,0,0,0,0,0,0,0,0,0,0,0,0,0,14,14,14,14,14,14,0,0,0,0,0,0,0,0,0,0,0,0,0,0,0,0,0,0,14,14,14,14,14,14,14,14,14,14,14,14,0,0,0,0,0,0,0,0,0,0,0,0,14,14,14,14,0,0,0,0,0,0,0,0,0,0,0,0,0,0,0,0,0,0,0,0,0,0,0,0,0,0,0
15,15,15,15,15,15,15,15,14,12,11,10,14,15,15,0,14,14,0,0,0,0,0,0,0,0,0,0,0,0,0,0,0,0,0,0,0,0,0,0,0,0,0,0,0,0,0,0,0,14,14,14,14,14,14,0,0,0,0,0,0,0,0,0,0,0,0,0,0,0,0,0,0,0,14,0,14,14,14,14,14,14,14,14,14,0,0,0,0,0,0,0,0,0,0,0,0,14,0,0,14,0,0,0,0,0,0,0,0,0,0,0,0,0,0,0,0,0,0,0,0,0,0,0,0,0,0,0
15,15,15,15,15,15,15,14,14,11,10,9,14,15,15,15,0,0,0,0,0,0,0,15,0,0,0,0,0,0,0,0,0,0,0,0,0,0,0,0,0,0,0,0,0,0,0,0,0,14,13,14,14,14,0,0,0,0,0,0,0,0,0,0,0,0,0,0,0,0,0,0,0,0,14,0,0,0,14,14,14,14,14,13,14,0,0,0,0,0,0,0,0,0,0,0,14,0,0,0,14,14,0,0,0,0,0,0,0,0,0,0,0,0,0,0,0,0,0,0,0,0,0,0,0,0,0,0
15,15,15,15,15,15,14,14,12,10,9,9,14,15,15,15,0,0,0,0,13,14,14,15,0,0,0,0,0,0,0,0,0,0,0,0,0,0,0,0,0,0,0,0,0,0,0,0,0,0,14,14,14,14,0,0,0,0,0,0,0,0,0,0,0,0,0,0,0,0,0,0,0,0,14,0,0,0,0,14,14,14,14,14,0,0,0,0,0,0,0,0,0,0,0,14,0,0,14,14,0,14,0,0,0,0,0,0,0,0,0,0,0,0,0,0,0,0,0,0,0,0,0,0,0,0,0,0
15,15,15,15,15,15,14,12,12,11,10,9,14,15,15,12,13,13,13,14,14,14,14,15,0,0,0,0,0,0,0,0,0,0,0,0,0,0,0,0,0,0,0,0,0,0,0,0,0,0,14,13,14,14,0,0,0,0,0,0,0,0,0,0,0,0,0,0,0,0,0,0,0,0,14,0,0,0,0,0,14,14,0,0,0,0,0,0,0,0,0,0,0,0,0,14,0,0,0,14,14,0,14,0,0,0,0,0,0,0,0,0,0,0,0,0,0,0,0,0,0,0,0,0,0,0,0,0
15,15,15,15,15,15,13,12,11,10,10,9,13,11,11,12,12,14,14,14,14,15,15,15,0,0,0,0,0,0,0,0,0,0,0,0,0,0,0,0,0,0,0,0,0,0,0,0,0,0,0,14,14,0,14,0,0,0,0,0,0,0,0,0,0,0,0,0,0,0,0,0,0,0,14,14,0,0,0,0,14,0,0,0,0,0,0,0,0,0,0,0,0,0,14,0,0,0,0,0,0,0,14,0,0,0,0,0,0,0,0,0,0,0,0,0,0,0,0,0,0,0,0,0,0,0,0,0
15,15,15,15,15,15,14,12,11,11,9,9,10,11,14,14,14,14,15,15,15,15,15,0,0,0,0,0,0,0,0,0,0,0,0,0,0,0,0,0,0,0,0,0,0,0,0,0,0,0,0,14,0,0,14,14,0,0,0,0,0,0,0,0,0,0,0,0,0,0,0,0,0,0,14,14,0,0,0,0,0,0,0,0,0,0,0,0,0,0,0,0,0,14,0,0,0,0,0,14,14,13,14,0,0,0,0,0,0,0,0,0,0,0,0,0,0,0,0,0,0,0,0,0,0,0,0,0
15,15,15,15,15,15,14,12,11,11,12,9,9,11,14,14,14,14,15,15,15,15,15,0,0,0,0,0,0,0,0,0,0,0,0,0,0,0,0,0,0,0,0,0,0,0,0,0,0,0,0,0,0,0,14,13,0,0,0,0,0,0,0,0,0,0,0,0,0,0,0,0,0,0,0,14,0,0,0,0,0,0,0,0,0,0,0,0,0,0,0,0,0,0,0,0,0,0,14,0,0,14,14,0,0,0,0,0,0,0,0,0,0,0,0,0,0,0,0,0,0,0,0,0,0,0,0,0
15,15,15,15,15,15,14,12,12,11,11,11,11,12,14,15,15,15,15,15,15,15,0,0,0,0,0,0,0,0,0,0,0,0,0,0,0,0,0,0,0,0,0,0,0,0,0,0,0,0,0,0,0,0,14,14,0,0,0,0,0,0,0,0,0,0,0,0,0,0,0,0,0,0,0,14,14,14,0,0,0,0,0,0,0,0,0,0,0,0,0,0,14,14,0,0,0,0,0,0,0,14,0,0,0,0,0,0,0,0,0,0,0,0,0,0,0,0,0,0,0,0,0,0,0,0,0,0
14,14,15,15,15,15,14,14,14,13,11,12,12,14,15,15,15,15,15,15,15,0,0,0,0,0,0,0,0,0,0,0,0,0,0,0,0,0,0,0,0,0,0,0,0,0,0,0,0,0,0,0,0,0,0,0,0,0,0,0,0,0,0,0,0,0,0,0,0,0,14,14,14,0,0,0,14,14,14,0,0,0,0,0,0,0,0,0,0,0,0,0,14,14,14,0,0,0,0,0,0,0,0,0,0,0,0,0,0,0,0,0,0,0,0,0,0,0,0,0,0,0,0,0,0,0,0,0
14,14,14,14,14,13,15,15,15,14,11,12,13,14,15,15,15,15,15,15,15,0,0,0,0,0,0,0,0,0,0,0,0,0,0,0,0,0,0,0,0,0,0,0,0,0,0,0,0,0,0,0,0,0,0,0,0,0,0,0,0,0,0,0,0,0,0,0,0,0,0,14,14,14,0,0,14,14,14,0,0,0,0,0,0,0,0,0,0,0,14,13,14,14,14,0,0,0,0,0,0,0,0,0,0,0,0,0,0,0,0,0,0,0,0,0,0,0,0,0,0,0,0,0,0,0,0,0
13,13,13,14,14,13,13,15,15,15,14,14,14,14,15,15,15,15,15,15,0,0,0,0,0,0,0,0,0,0,0,0,0,0,0,0,0,0,0,0,0,0,0,0,0,0,0,0,0,0,0,0,0,0,0,0,0,0,0,0,0,0,0,0,0,0,0,0,0,0,0,0,14,14,14,0,0,14,14,0,0,0,0,0,0,0,0,0,0,14,14,13,14,14,0,0,0,0,0,0,0,0,0,0,0,0,0,0,0,0,0,0,0,0,0,0,0,0,0,0,0,0,0,0,0,0,0,0
13,12,11,14,13,13,13,14,15,15,14,14,15,15,15,15,15,15,15,0,0,0,0,0,0,0,0,0,0,0,0,0,0,0,0,0,0,0,0,0,0,0,0,0,0,0,0,0,0,0,0,0,0,0,0,0,0,0,0,0,0,0,0,0,0,0,0,0,0,0,0,0,0,14,14,14,0,14,14,14,0,0,0,0,0,0,0,14,14,14,13,13,14,14,0,0,0,0,0,0,0,0,0,0,0,0,0,0,0,0,0,0,0,0,0,0,0,0,0,0,0,0,0,0,0,0,0,0
13,13,12,13,13,14,13,11,14,13,15,15,15,15,15,15,15,15,0,0,0,0,0,0,0,0,0,0,0,0,0,0,0,0,0,0,0,0,0,0,0,0,0,0,0,0,0,0,0,0,0,0,0,0,0,0,0,0,0,0,0,0,0,0,0,0,0,0,0,0,0,0,0,0,14,14,14,0,0,14,0,0,0,0,0,14,14,14,14,14,13,14,14,14,14,0,0,0,0,0,0,14,0,0,14,14,0,0,0,0,0,0,0,0,0,0,0,0,0,0,0,0,0,0,0,0,0,0
12,11,12,12,12,13,13,11,11,11,14,15,15,15,15,15,0,0,0,0,0,0,0,0,0,0,0,0,0,0,0,0,0,0,0,0,0,0,0,0,0,0,0,0,0,0,0,0,0,0,0,0,0,0,0,0,0,0,0,0,0,0,0,0,0,0,0,0,0,0,0,0,0,0,14,14,14,14,14,0,0,0,0,0,0,14,14,14,14,14,14,14,14,14,0,0,14,14,14,14,14,0,0,0,14,0,0,0,0,0,0,0,0,0,0,0,0,0,0,0,0,0,0,0,0,0,0,0
12,12,12,12,0,0,11,9,9,10,14,15,15,15,15,0,0,0,0,0,0,0,0,0,0,0,0,0,0,0,0,0,0,0,0,0,0,0,0,0,0,0,0,0,0,0,0,0,0,0,0,0,0,0,0,0,0,0,0,0,0,0,0,0,0,0,0,0,0,0,0,0,0,0,0,14,14,14,14,0,0,0,0,0,0,14,14,14,14,14,14,14,14,14,0,0,14,0,0,0,0,0,0,0,14,0,0,0,0,0,0,0,0,0,0,0,0,0,0,0,0,0,0,0,0,0,0,0
