4,4,4,4,4,4,4,4,5,4,4,4,4,4,4,4,4,4,4,4,3,4,4,4,4,4,4,4,4,4,4,3,3,3,3,3,3,3,3,3,3,3,3,3,3,3,4,4,3,3,3,3,3,3,4,5,6,7,7,6,5,5,4,4,4,3,4,4,4,4,3,3,3,2,2,2,2,3,4,5,4,3,2,2,2,2,2,2,2,2,2,1,1,1,2,2,2,2,2,2,2,2,2,3,3,3,3,4,4,4,4,5,5,5,6,7,8,8,0,9,9,0,0,0,0,0,0,0
4,4,4,4,4,4,4,4,4,4,4,4,4,4,4,4,4,3,3,3,3,3,3,3,3,3,3,3,4,4,3,3,3,3,3,3,3,3,3,3,3,3,3,3,3,3,4,3,3,3,3,3,3,3,4,5,6,7,7,6,5,4,4,3,3,3,3,3,3,3,3,3,2,2,2,2,2,3,4,4,4,3,2,2,2,2,2,2,2,2,2,1,1,1,2,2,2,2,2,2,2,2,2,3,3,3,3,4,4,4,4,5,5,6,6,7,8,8,0,9,9,0,0,0,0,0,0,0
4,4,4,4,4,4,4,4,4,4,4,4,4,4,4,4,3,3,3,3,3,3,3,3,3,3,3,3,3,3,3,3,3,3,3,3,3,3,3,3,3,3,3,3,3,3,3,3,3,3,3,3,3,3,4,4,5,6,6,5,5,4,4,3,2,2,2,2,2,2,2,2,2,2,2,2,2,2,3,3,3,3,2,2,2,2,2,2,2,1,1,1,1,1,2,2,2,2,2,2,2,2,2,3,3,3,3,4,4,4,4,5,5,6,7,8,8,9,0,9,9,9,0,0,0,0,0,0
4,4,4,4,4,4,4,4,4,4,4,4,4,4,4,3,3,3,3,3,3,3,3,3,3,3,3,3,3,3,3,3,3,3,3,3,3,3,3,3,3,3,3,3,3,3,3,3,3,3,3,3,3,3,4,4,5,5,5,5,4,4,3,3,2,2,2,2,2,2,2,2,2,2,2,1,1,2,2,3,2,2,2,2,2,2,2,2,1,1,1,1,1,1,2,2,2,2,2,2,2,2,2,3,3,3,3,4,4,4,4,5,5,6,7,8,9,9,0,9,9,9,0,0,0,0,0,0
3,4,4,3,3,4,4,4,3,3,3,4,4,4,3,3,3,3,3,3,3,3,2,2,2,2,3,3,3,3,3,3,3,3,2,2,2,3,3,3,3,3,3,3,3,3,3,3,3,3,3,3,3,4,4,4,4,4,4,4,4,3,3,2,2,2,1,1,1,2,2,2,2,2,2,1,1,2,2,2,2,2,2,2,2,2,1,2,1,1,1,1,1,1,1,2,2,2,2,2,2,2,2,3,3,3,4,4,4,4,5,5,6,6,7,8,9,9,0,9,0,0,0,0,0,0,0,0
3,3,3,3,3,3,4,3,3,3,3,4,4,4,3,3,3,3,2,2,2,2,2,2,2,2,2,2,3,3,3,2,2,2,2,2,2,2,2,2,2,2,2,2,2,3,2,2,2,3,3,3,3,4,4,4,4,4,4,4,3,3,2,2,2,1,1,1,1,1,1,2,2,2,1,1,2,2,2,2,2,2,2,1,1,1,1,1,1,1,1,1,1,1,2,2,2,2,2,2,2,2,2,3,3,3,3,4,4,4,5,5,6,7,8,8,9,0,0,9,0,0,0,0,0,0,0,0
3,3,3,3,3,3,3,3,3,3,3,4,4,4,3,3,3,3,2,2,2,2,2,2,2,2,2,2,2,2,2,2,2,2,2,2,2,2,2,2,2,2,2,2,2,2,2,2,2,2,3,3,3,4,4,4,4,4,4,3,3,2,2,2,1,1,1,1,1,1,1,1,1,1,1,1,2,1,1,1,1,1,1,1,1,1,1,1,1,1,1,1,1,1,2,2,2,2,2,2,2,2,2,3,3,3,3,4,4,4,5,6,6,7,8,8,9,0,0,9,0,0,0,0,0,0,0,0
3,3,3,3,3,3,3,3,3,3,0,0,4,4,3,3,3,2,2,2,2,2,2,2,0,0,2,2,2,2,2,2,2,2,2,2,2,2,2,2,2,2,2,2,2,2,2,2,2,2,3,3,4,4,4,4,4,3,3,3,2,2,2,1,1,1,1,1,1,1,1,1,1,1,1,1,1,1,1,1,1,1,1,1,1,1,1,1,1,1,1,1,1,2,2,2,2,2,2,2,2,2,2,3,3,3,4,4,4,5,5,6,6,7,8,9,0,0,0,9,9,0,0,0,0,0,0,0
3,3,3,0,4,4,3,0,0,0,0,4,4,4,4,3,3,3,2,2,2,2,0,0,0,0,2,2,2,2,2,2,2,2,2,2,2,2,2,2,2,2,2,2,2,2,2,2,3,3,3,3,4,4,4,3,3,3,3,2,2,2,2,2,1,1,1,1,1,1,1,1,1,1,1,1,1,1,1,1,1,1,1,1,1,1,1,1,1,1,1,1,1,2,2,2,2,2,2,2,2,2,3,3,3,3,4,4,4,5,6,6,6,7,8,9,0,0,0,9,0,0,0,0,0,0,0,0
3,3,0,0,0,4,3,0,0,0,5,5,5,5,4,4,3,3,3,3,3,0,0,0,0,0,2,2,2,2,2,2,2,2,2,2,2,2,2,2,2,2,2,2,2,2,2,2,3,3,3,4,4,4,3,3,3,3,2,2,2,2,2,2,1,1,1,1,1,1,1,1,1,1,1,1,1,1,1,1,1,1,1,1,1,1,1,1,1,1,1,1,1,2,2,2,2,2,2,3,3,3,3,3,3,4,4,4,5,5,6,6,6,7,8,0,0,0,0,0,0,0,0,0,0,0,0,9
4,4,0,0,0,0,4,4,0,5,6,7,7,6,5,4,4,3,3,3,0,0,0,0,2,2,2,2,2,2,2,2,2,2,2,2,2,1,2,2,2,2,2,2,2,3,3,3,3,3,4,4,4,4,3,3,3,2,2,2,2,2,2,2,1,1,1,1,1,1,1,1,1,1,1,1,1,1,1,1,1,1,1,1,1,1,1,1,1,1,1,2,2,2,2,2,2,2,2,3,3,3,3,3,3,4,4,4,5,6,6,6,7,7,0,0,0,0,0,9,0,0,0,0,0,9,0,0
4,0,0,0,0,0,0,0,0,0,0,9,8,8,7,5,4,4,3,3,0,0,0,2,2,2,2,2,1,2,1,2,2,2,2,1,1,1,1,2,2,2,2,3,3,3,3,3,4,4,4,4,4,4,3,3,2,2,2,2,2,2,2,2,2,1,1,1,1,1,1,1,1,1,1,1,1,1,1,1,1,1,1,1,1,1,1,1,1,1,2,2,2,2,2,2,2,2,3,3,3,3,4,4,4,4,4,4,5,6,6,7,7,0,0,0,0,0,0,9,9,0,0,9,0,0,0,0
0,0,0,0,0,0,0,0,0,0,0,0,9,9,7,6,5,5,4,4,0,0,0,0,2,2,2,2,2,1,1,1,1,1,1,1,1,1,1,2,2,2,3,3,3,3,3,4,4,4,4,4,4,4,3,2,2,2,2,2,2,2,2,2,1,1,1,1,1,1,1,1,1,1,1,1,1,1,1,1,1,1,1,1,1,1,1,1,1,2,2,2,2,2,2,2,2,3,3,3,4,4,4,4,4,4,4,5,6,7,7,7,0,0,0,0,0,0,0,9,9,9,9,0,0,0,0,0
0,0,0,0,0,0,0,0,0,0,0,0,0,0,9,8,7,7,6,5,5,0,0,0,0,0,2,2,2,1,1,1,1,1,1,1,1,1,1,2,2,2,3,4,5,4,4,4,4,3,3,3,3,3,2,2,2,2,1,1,1,2,2,1,1,1,1,1,1,1,1,1,1,1,1,1,1,1,1,1,1,1,1,1,1,1,1,2,2,2,2,2,2,2,2,2,2,3,3,4,4,4,4,4,4,4,4,5,0,7,8,0,0,0,0,0,0,9,9,9,9,0,0,0,0,0,0,0
0,0,0,0,0,0,0,0,0,0,0,0,0,0,9,8,6,6,6,7,6,0,0,0,0,0,2,2,2,1,1,1,1,1,1,1,1,1,1,2,2,3,4,5,5,5,5,5,4,3,2,2,2,2,2,2,1,1,1,1,1,1,1,1,1,1,1,1,1,1,1,1,1,1,1,1,1,1,1,1,1,1,1,1,1,2,2,2,2,2,2,2,2,2,2,2,3,3,4,4,5,5,5,5,5,5,5,0,0,0,0,0,0,0,0,0,0,9,0,0,9,0,0,0,0,0,0,0
8,0,0,0,6,5,4,5,6,0,0,0,0,0,7,6,5,5,5,6,6,6,0,0,0,0,0,2,2,2,1,1,1,1,1,1,1,1,1,2,2,3,4,5,5,4,5,5,4,3,2,2,2,2,2,1,1,1,1,1,1,1,1,1,1,1,1,1,1,1,1,1,1,1,1,1,1,1,1,1,1,1,1,1,2,2,2,2,2,2,2,2,2,2,3,3,3,3,4,4,5,5,5,5,6,6,6,0,0,0,0,0,0,0,0,0,0,0,9,0,0,0,0,0,0,0,0,0
0,7,6,5,4,3,3,3,4,5,5,6,6,6,6,5,4,5,6,5,5,6,5,0,0,0,2,2,2,2,2,1,1,1,1,1,1,1,1,2,3,3,3,4,4,3,4,4,4,3,2,1,1,1,1,1,1,1,1,1,1,1,1,1,1,1,1,1,1,1,1,1,1,1,1,1,1,1,1,1,1,1,1,2,2,2,3,3,3,3,3,3,2,2,3,3,3,0,0,5,5,6,6,6,7,7,0,0,0,0,0,0,0,0,0,0,0,9,9,0,0,0,0,0,0,0,0,0
6,5,4,4,3,3,3,3,3,4,4,5,6,6,6,6,5,4,5,6,5,5,0,0,0,0,2,2,2,2,2,1,1,1,1,1,1,1,1,2,2,3,4,5,5,5,5,4,3,2,1,1,1,1,1,1,1,1,1,1,1,1,1,1,1,1,1,1,1,1,1,1,1,1,1,1,1,1,1,1,1,1,2,2,2,3,3,3,3,3,3,3,3,2,3,3,0,0,4,5,5,5,6,6,7,0,0,0,0,0,0,0,0,0,0,0,0,9,9,0,0,0,0,0,0,0,0,0
5,5,4,4,4,3,3,3,3,4,5,5,6,7,7,6,5,4,4,5,5,4,0,0,0,0,0,2,2,2,2,1,1,1,1,1,1,1,1,2,2,3,4,5,5,6,6,4,3,2,1,1,1,1,1,1,1,1,1,1,1,1,1,1,1,1,1,1,1,1,1,1,1,1,1,1,1,1,1,2,2,2,2,2,3,3,3,4,4,4,3,3,3,3,3,0,0,0,4,0,0,0,5,6,0,0,0,0,0,0,0,0,0,0,0,0,0,9,9,0,0,0,0,0,0,0,0,0
4,4,5,5,4,3,3,3,4,4,4,5,5,6,8,7,6,4,4,5,5,4,0,0,0,0,0,2,2,2,2,2,1,1,1,1,1,1,1,1,2,2,3,4,5,5,5,4,2,2,1,1,1,1,1,1,1,1,1,1,1,1,1,1,1,1,1,1,1,1,1,1,1,1,2,2,2,2,2,2,2,2,2,3,3,3,4,4,4,4,3,3,3,3,0,0,0,0,0,0,0,5,5,6,7,0,0,0,0,0,0,0,0,0,0,0,0,9,9,0,0,0,0,0,0,0,0,0
5,4,5,5,4,3,3,5,6,5,4,4,4,4,5,6,6,5,3,4,4,4,0,0,0,0,0,2,2,2,2,2,2,1,1,1,1,1,1,1,1,2,2,3,4,4,4,3,3,2,1,1,1,1,1,1,1,1,1,1,1,1,1,1,1,1,1,1,1,1,1,1,1,1,2,2,2,2,2,2,2,2,3,3,4,4,4,4,4,4,4,3,3,3,4,0,0,4,0,0,0,0,0,5,5,9,0,0,0,0,0,0,0,0,0,0,9,10,0,0,0,0,0,0,0,0,0,0
6,5,4,6,6,4,4,6,8,5,3,3,3,3,3,3,4,4,4,4,4,4,3,3,0,0,0,2,2,2,2,2,2,2,1,1,1,1,1,1,1,1,2,3,4,4,4,3,2,2,2,1,1,1,1,1,1,1,1,1,1,1,1,1,1,1,1,1,1,1,1,1,1,1,2,2,2,3,3,3,3,3,4,4,4,4,4,4,4,4,4,4,4,4,4,4,4,5,5,0,0,0,0,6,5,7,0,0,0,0,0,0,0,0,8,9,10,10,0,0,0,0,0,0,0,0,0,0
0,5,0,0,6,5,0,0,7,3,2,2,2,2,2,2,2,3,3,4,3,3,3,3,3,3,2,1,1,1,2,2,2,1,1,1,1,1,1,1,1,2,2,3,4,4,3,3,2,2,2,1,1,1,1,1,1,1,1,1,1,1,1,1,1,1,1,1,1,1,1,1,1,2,2,2,3,3,4,4,4,4,4,5,5,5,5,5,5,5,4,4,4,4,4,4,5,0,0,0,0,0,0,6,6,6,0,0,0,0,0,0,0,9,9,10,11,11,0,0,0,0,0,0,0,0,0,0
0,0,0,0,0,0,0,0,5,3,2,2,1,1,2,1,1,2,2,4,3,3,3,2,2,1,1,1,1,1,1,1,1,1,1,1,1,1,1,2,2,2,2,3,3,4,4,3,3,2,2,1,1,1,1,1,1,1,1,1,1,1,1,1,1,1,1,1,1,1,1,2,2,2,2,3,3,4,4,4,4,5,5,6,6,6,6,5,5,5,5,4,4,5,5,5,0,0,0,0,0,0,0,7,7,7,0,0,0,9,9,9,9,10,10,11,12,12,0,0,0,0,0,0,0,0,0,0
0,0,0,0,0,3,0,0,4,3,2,1,1,1,1,1,1,1,2,4,4,3,3,2,1,1,1,1,1,1,1,1,1,1,1,1,1,1,1,2,2,2,2,3,3,3,4,4,4,3,2,1,1,1,1,1,1,1,1,1,2,2,1,1,1,1,1,1,1,1,2,2,2,2,3,3,4,4,5,5,5,6,6,7,7,7,7,6,6,6,6,5,5,5,5,5,0,0,0,0,0,0,0,8,7,0,0,0,10,10,9,0,10,11,12,12,0,0,0,0,0,0,0,0,0,0,0,0
0,0,0,0,0,0,0,0,3,2,2,1,1,1,1,1,1,1,2,3,3,3,3,2,2,1,1,1,1,1,1,1,1,1,1,1,1,1,1,1,1,2,2,3,3,2,3,4,4,3,2,2,1,1,1,1,1,2,2,2,2,2,2,1,1,1,1,1,1,2,2,2,3,3,3,4,4,5,5,6,6,6,7,8,8,8,8,7,7,7,6,6,6,6,5,5,5,0,0,0,0,0,0,0,0,0,0,9,0,10,11,12,12,0,0,0,0,0,0,0,0,0,0,0,0,0,0,0
0,0,0,0,0,0,0,3,2,1,1,1,1,1,1,1,1,1,1,2,2,2,3,3,2,1,1,1,1,1,1,1,1,1,1,1,1,1,1,1,1,1,2,2,2,2,2,3,3,3,2,2,2,1,1,2,2,2,2,2,2,2,2,2,1,1,1,1,2,2,2,3,3,3,3,4,4,5,6,6,6,7,8,9,9,9,8,8,7,7,7,7,7,6,6,6,6,0,0,0,0,0,0,0,0,0,9,10,12,12,0,0,0,0,0,0,0,0,0,0,0,0,0,0,0,0,0,0
0,0,0,0,0,0,0,3,1,1,1,1,1,1,1,1,1,1,1,1,1,1,1,2,2,1,1,1,1,1,1,1,1,1,1,1,1,1,1,1,1,1,1,1,1,1,2,2,2,2,2,2,2,2,2,2,2,2,2,2,2,2,2,2,1,1,1,2,2,2,2,3,3,3,4,4,5,5,6,6,6,8,9,9,9,9,9,9,8,8,8,8,8,7,7,7,7,7,0,0,0,0,0,0,0,0,0,10,12,0,0,0,0,0,0,0,0,0,0,0,0,0,0,0,0,0,0,0
0,0,1,1,0,0,1,1,1,1,1,1,1,1,1,1,1,1,1,1,1,1,1,2,2,2,1,1,1,1,1,1,1,1,1,1,1,1,1,1,1,1,1,1,1,1,1,1,1,1,2,3,3,3,2,2,3,3,3,3,3,3,2,2,1,1,1,2,2,2,3,3,3,4,4,4,5,5,6,6,7,8,9,10,10,10,9,9,8,9,9,9,9,8,8,8,7,7,0,0,0,0,0,0,0,0,0,11,0,0,0,0,0,0,0,0,0,0,0,0,0,0,0,0,0,0,0,0
1,1,1,1,1,1,1,1,1,1,1,1,1,1,1,1,1,1,1,1,1,1,1,1,2,2,2,1,1,1,1,1,1,1,1,1,1,1,1,1,1,1,1,1,1,1,1,1,1,1,1,2,3,4,3,3,3,3,3,3,3,3,3,2,2,2,2,2,2,3,3,4,4,4,4,4,5,6,7,7,7,8,9,10,10,10,10,9,9,9,9,9,9,8,8,8,8,0,0,0,0,0,0,0,0,0,0,0,0,0,0,0,0,0,0,0,0,0,0,0,0,0,0,0,0,0,0,0
1,1,1,1,1,1,1,1,1,1,1,1,1,1,1,1,1,1,1,1,1,0,0,1,1,1,1,1,1,1,1,1,1,1,1,1,1,1,1,1,1,1,1,1,1,1,1,1,1,1,1,2,3,4,5,5,4,4,4,4,4,4,3,3,3,2,2,3,3,3,5,5,5,5,5,5,6,7,8,8,8,9,10,10,10,10,10,9,9,9,9,8,8,8,8,8,9,8,8,0,0,0,0,0,0,0,0,0,0,0,0,0,0,0,0,0,0,0,0,0,0,0,0,0,0,0,0,0
1,1,1,1,1,1,1,1,1,1,1,1,1,1,1,1,1,1,1,1,1,0,0,0,1,1,1,1,1,1,1,1,1,1,1,1,1,1,1,1,1,1,1,1,1,1,1,1,1,1,1,2,3,4,5,6,6,5,4,4,4,4,4,4,4,4,4,4,4,6,6,6,6,6,6,6,6,7,8,8,8,9,10,10,10,10,10,9,9,9,9,8,8,8,8,8,9,9,0,0,0,0,0,0,0,0,0,0,0,0,0,0,0,0,0,0,0,0,0,0,0,0,0,0,0,0,0,0
1,1,1,1,1,0,1,1,1,1,1,1,1,1,1,1,1,1,1,1,1,0,0,0,1,1,1,1,1,1,1,1,1,1,1,1,1,1,1,1,1,1,1,1,1,1,1,1,1,1,1,2,2,3,5,6,6,7,9,8,7,7,7,7,7,7,7,7,9,9,9,9,9,8,7,7,7,8,8,8,8,9,9,10,10,10,10,9,9,9,9,8,8,8,8,8,9,9,0,0,0,0,0,0,0,0,9,0,0,0,0,0,0,0,0,0,0,0,0,0,0,0,0,0,0,0,0,0
1,1,1,1,1,1,0,0,1,1,1,1,1,1,1,1,1,1,1,1,1,1,0,0,0,0,1,1,1,1,1,1,1,1,1,1,1,1,1,1,1,1,1,1,1,1,1,1,1,1,1,2,3,3,4,5,5,6,8,9,8,9,10,10,10,10,10,10,10,10,10,10,10,9,9,8,8,9,9,8,8,9,9,10,10,10,10,9,9,9,9,8,8,8,7,8,9,0,0,0,0,0,0,0,0,0,0,0,0,0,0,0,0,0,0,0,0,0,0,0,0,0,0,0,0,0,0,0
1,1,1,1,1,1,0,0,0,1,1,1,1,1,1,1,1,1,1,1,1,1,1,0,0,0,0,0,0,0,0,1,1,1,1,1,1,1,1,1,1,1,1,1,1,1,1,1,1,2,2,2,3,3,4,4,4,5,6,8,9,9,10,11,11,11,11,11,11,10,10,11,11,10,9,9,9,9,9,9,9,9,9,9,9,9,9,9,9,9,9,9,8,8,7,7,0,0,0,0,0,0,0,0,9,0,0,0,0,0,0,0,0,0,0,0,0,0,0,0,0,0,0,0,0,0,0,0
1,1,1,1,1,1,1,0,0,1,1,1,1,1,1,1,1,1,1,1,1,1,1,1,1,0,0,0,0,1,0,0,1,1,1,1,1,1,1,1,1,1,1,1,1,1,1,2,2,2,2,2,3,3,3,4,4,4,5,7,9,9,10,11,12,12,12,12,11,11,11,11,12,11,10,10,9,9,9,9,9,9,9,9,9,9,9,9,9,9,9,8,8,7,7,7,0,0,0,0,0,0,0,0,0,0,0,0,0,0,0,0,0,0,0,0,0,0,0,0,0,0,0,0,0,0,0,0
1,1,1,1,1,1,1,0,0,0,1,1,1,1,1,1,1,1,1,1,1,1,1,1,1,0,0,0,1,1,0,0,0,0,0,0,0,0,0,0,0,1,1,1,1,1,2,2,2,2,2,2,3,3,3,3,4,5,6,7,8,9,10,10,11,12,12,12,12,11,11,12,12,11,11,10,10,9,9,9,9,9,9,9,9,9,9,9,9,9,9,8,8,7,6,0,0,11,0,0,0,0,0,0,0,0,0,0,0,0,0,0,0,0,0,0,0,0,0,0,0,0,0,0,0,0,0,0
1,1,1,1,1,1,1,1,0,0,0,1,1,1,1,1,1,1,1,1,1,1,1,1,1,1,1,1,1,1,1,0,0,0,0,0,0,0,0,0,0,0,1,1,2,2,2,2,3,3,2,2,3,4,3,3,4,6,6,7,8,9,10,10,11,12,12,12,12,12,12,12,12,11,11,10,10,9,9,9,9,9,8,8,8,9,9,8,9,9,9,9,8,7,0,0,7,11,0,0,0,0,0,0,0,0,0,0,0,0,0,0,0,0,0,0,0,0,0,0,0,0,0,0,0,0,0,0
1,1,1,1,1,1,1,1,0,0,0,1,1,1,1,1,1,1,1,1,1,1,1,1,1,1,1,1,1,1,1,1,1,0,0,0,0,0,0,0,0,0,0,2,2,2,2,2,3,3,3,3,3,4,4,4,5,6,6,7,8,9,10,11,12,12,12,12,12,12,12,12,12,11,11,11,11,10,10,10,10,9,9,8,8,9,9,9,10,10,10,10,0,0,0,0,10,11,0,0,0,0,0,0,0,0,0,0,0,0,0,0,0,0,0,0,0,0,0,0,0,0,0,0,0,0,0,0
1,1,1,1,1,1,1,1,1,0,0,1,1,1,1,1,1,1,1,1,1,1,1,1,1,1,1,1,1,1,1,1,1,0,0,0,0,0,0,0,0,0,0,2,2,2,2,3,3,3,3,3,4,5,5,5,5,5,6,8,9,11,12,12,12,12,0,12,12,12,12,12,12,12,11,11,10,10,10,10,10,10,10,10,10,10,10,10,10,0,0,0,0,0,0,0,0,0,0,0,0,0,0,0,0,0,0,0,0,0,0,0,0,0,0,0,0,0,0,0,0,0,0,0,0,0,0,0
1,1,1,1,1,1,1,1,1,1,0,0,1,2,1,1,1,1,1,1,1,1,1,1,1,1,1,1,1,1,1,1,0,0,0,0,0,0,0,0,0,0,0,0,2,2,0,4,4,4,4,4,4,5,5,5,5,5,6,9,10,12,0,0,0,0,0,12,12,12,12,12,12,12,11,11,10,10,10,10,10,10,11,0,0,11,0,0,0,0,0,0,0,0,0,0,0,0,0,0,0,0,0,0,0,0,0,0,0,0,0,0,0,0,0,0,0,0,0,0,0,0,0,0,0,0,0,0
1,1,1,1,1,1,1,1,1,2,0,0,0,1,2,1,1,1,1,1,1,1,1,1,1,1,1,1,1,1,1,0,0,0,0,0,0,0,0,0,0,0,0,0,0,0,0,4,5,5,6,6,5,5,6,6,6,7,9,11,12,12,0,0,0,0,0,0,12,12,12,12,12,11,11,11,10,10,10,11,11,11,0,0,0,0,0,0,0,0,0,0,0,0,0,0,0,0,0,0,0,0,0,0,0,0,0,0,0,0,0,0,0,0,0,0,0,0,0,0,0,0,0,0,0,0,0,0
1,1,1,1,1,1,1,1,1,2,0,0,0,1,2,2,1,1,1,1,1,1,1,1,1,1,1,1,1,1,1,0,0,0,0,0,0,0,0,0,0,0,0,0,0,0,0,5,6,7,8,7,7,7,8,8,9,10,11,12,0,0,0,0,0,0,0,0,0,12,12,12,11,11,11,10,10,10,10,10,11,0,0,0,12,12,12,0,0,0,0,0,0,0,0,0,0,0,0,0,0,0,0,0,0,0,0,0,0,0,0,0,0,0,0,0,0,0,0,0,0,0,0,0,0,0,0,0
1,1,1,1,1,1,1,1,1,1,1,0,0,0,1,2,2,1,1,1,1,1,1,1,1,1,1,1,1,2,0,0,0,0,0,0,0,0,0,0,0,0,0,0,0,0,0,7,8,8,9,9,9,9,9,10,11,12,12,0,0,0,0,0,0,0,0,0,0,12,12,12,11,11,11,10,10,9,9,9,11,12,0,0,0,12,0,0,0,0,0,0,0,0,0,0,0,12,12,0,0,0,0,0,0,0,0,0,0,0,0,0,0,0,0,0,0,0,0,0,0,0,0,0,0,0,0,0
1,1,1,1,1,1,1,1,1,1,2,0,0,0,0,1,2,1,1,1,1,1,1,1,1,1,2,2,0,0,0,0,0,0,0,0,0,0,0,0,0,0,0,0,0,0,0,8,9,9,9,9,9,9,9,11,12,12,0,0,0,0,0,0,0,0,0,0,0,0,12,12,12,11,12,11,10,10,9,8,10,12,12,0,0,0,0,0,0,0,0,0,0,0,0,0,0,12,12,0,0,0,0,0,0,0,0,0,0,0,0,0,0,0,0,0,0,0,0,0,0,0,0,0,0,0,0,0
1,1,1,1,1,1,1,1,1,1,2,2,0,0,0,1,2,2,1,1,1,1,1,1,1,1,0,0,0,0,0,0,0,0,0,0,0,0,0,0,0,0,0,0,0,0,0,9,10,10,10,10,9,10,11,12,12,0,0,0,0,0,0,0,0,0,0,0,0,12,12,12,0,11,12,12,10,10,10,9,10,12,12,12,0,0,0,0,0,0,0,0,0,0,0,0,0,12,12,0,0,0,0,0,0,0,0,0,0,0,0,0,0,0,0,0,0,0,0,0,0,0,0,0,0,0,0,0
1,1,1,1,1,1,1,1,2,2,2,2,0,0,0,1,2,2,2,1,1,1,1,1,1,0,0,0,0,0,0,0,0,0,0,0,0,0,0,0,0,0,0,0,0,0,0,0,10,10,10,10,10,11,12,12,0,0,0,0,0,0,0,0,0,0,0,0,0,0,0,0,0,12,12,12,11,11,11,10,10,11,12,12,12,0,0,0,0,0,0,0,0,0,0,0,12,12,0,0,0,0,0,0,0,0,0,0,0,0,0,0,0,0,0,0,0,0,0,0,0,0,0,0,0,0,0,0
1,1,1,1,1,1,2,2,2,2,2,2,1,1,0,0,2,3,2,1,1,1,1,0,0,0,0,0,0,0,0,0,0,0,0,0,0,0,0,0,0,0,0,0,0,0,0,0,10,10,10,10,11,12,12,0,0,0,0,0,0,0,0,0,0,0,0,0,0,0,0,0,0,12,12,12,12,12,11,11,10,11,12,12,12,0,0,0,0,0,0,0,0,0,0,0,12,12,0,0,0,0,0,0,0,0,0,0,0,0,0,0,0,0,0,0,0,0,0,0,0,0,0,0,0,0,0,0
2,2,1,1,1,2,2,3,3,4,3,2,1,1,1,0,2,2,2,1,1,0,0,0,0,0,0,0,0,0,0,0,0,0,0,0,0,0,0,0,0,0,0,0,0,0,0,0,0,11,11,11,11,12,12,0,0,0,0,0,0,0,0,0,0,0,0,0,0,0,0,0,0,12,12,12,12,12,12,12,12,12,12,12,12,0,0,0,0,0,0,0,0,0,0,0,0,12,12,12,12,0,0,0,0,0,0,0,0,0,0,0,0,0,0,0,0,0,0,0,0,0,0,0,0,0,0,0
3,3,3,3,3,3,3,4,5,6,5,3,2,1,1,0,1,1,0,0,0,0,0,0,0,0,0,0,0,0,0,0,0,0,0,0,0,0,0,0,0,0,0,0,0,0,0,0,0,12,12,11,12,12,12,0,0,0,0,0,0,0,0,0,0,0,0,0,0,0,0,0,0,0,12,0,12,12,12,12,12,12,12,12,12,0,0,0,0,0,0,0,0,0,0,0,0,12,0,0,12,0,0,0,0,0,0,0,0,0,0,0,0,0,0,0,0,0,0,0,0,0,0,0,0,0,0,0
4,5,6,6,5,5,5,6,8,8,7,5,3,1,1,2,0,0,0,0,0,0,0,1,0,0,0,0,0,0,0,0,0,0,0,0,0,0,0,0,0,0,0,0,0,0,0,0,0,12,12,12,12,12,0,0,0,0,0,0,0,0,0,0,0,0,0,0,0,0,0,0,0,0,12,0,0,0,12,12,12,12,12,12,12,0,0,0,0,0,0,0,0,0,0,0,12,0,0,0,12,12,0,0,0,0,0,0,0,0,0,0,0,0,0,0,0,0,0,0,0,0,0,0,0,0,0,0
5,6,8,8,7,8,9,9,9,9,7,6,4,2,1,2,0,0,0,0,3,3,2,1,0,0,0,0,0,0,0,0,0,0,0,0,0,0,0,0,0,0,0,0,0,0,0,0,0,0,12,12,12,12,0,0,0,0,0,0,0,0,0,0,0,0,0,0,0,0,0,0,0,0,12,0,0,0,0,12,12,12,12,12,0,0,0,0,0,0,0,0,0,0,0,12,0,0,12,12,0,12,0,0,0,0,0,0,0,0,0,0,0,0,0,0,0,0,0,0,0,0,0,0,0,0,0,0
6,7,9,8,9,9,10,10,9,9,7,6,5,2,2,3,3,3,3,3,4,4,3,2,0,0,0,0,0,0,0,0,0,0,0,0,0,0,0,0,0,0,0,0,0,0,0,0,0,0,12,12,12,12,0,0,0,0,0,0,0,0,0,0,0,0,0,0,0,0,0,0,0,0,12,0,0,0,0,0,12,12,0,0,0,0,0,0,0,0,0,0,0,0,0,12,0,0,0,12,12,0,12,0,0,0,0,0,0,0,0,0,0,0,0,0,0,0,0,0,0,0,0,0,0,0,0,0
7,8,8,8,9,9,10,10,9,9,7,4,4,6,6,6,5,5,4,4,4,4,3,3,0,0,0,0,0,0,0,0,0,0,0,0,0,0,0,0,0,0,0,0,0,0,0,0,0,0,0,12,12,0,12,0,0,0,0,0,0,0,0,0,0,0,0,0,0,0,0,0,0,0,12,12,0,0,0,0,12,0,0,0,0,0,0,0,0,0,0,0,0,0,12,0,0,0,0,0,0,0,12,0,0,0,0,0,0,0,0,0,0,0,0,0,0,0,0,0,0,0,0,0,0,0,0,0
8,8,8,9,9,9,10,11,10,9,7,5,9,9,8,8,8,7,6,5,5,4,3,0,0,0,0,0,0,0,0,0,0,0,0,0,0,0,0,0,0,0,0,0,0,0,0,0,0,0,0,12,0,0,12,12,0,0,0,0,0,0,0,0,0,0,0,0,0,0,0,0,0,0,12,12,0,0,0,0,0,0,0,0,0,0,0,0,0,0,0,0,0,12,0,0,0,0,0,12,12,12,12,0,0,0,0,0,0,0,0,0,0,0,0,0,0,0,0,0,0,0,0,0,0,0,0,0
9,9,9,9,9,9,9,10,10,10,9,9,11,12,10,9,9,9,7,6,5,4,4,0,0,0,0,0,0,0,0,0,0,0,0,0,0,0,0,0,0,0,0,0,0,0,0,0,0,0,0,0,0,0,12,12,0,0,0,0,0,0,0,0,0,0,0,0,0,0,0,0,0,0,0,12,0,0,0,0,0,0,0,0,0,0,0,0,0,0,0,0,0,0,0,0,0,0,12,0,0,12,12,0,0,0,0,0,0,0,0,0,0,0,0,0,0,0,0,0,0,0,0,0,0,0,0,0
10,10,10,10,9,8,8,9,10,11,12,12,12,11,10,8,8,9,8,6,5,4,0,0,0,0,0,0,0,0,0,0,0,0,0,0,0,0,0,0,0,0,0,0,0,0,0,0,0,0,0,0,0,0,12,12,0,0,0,0,0,0,0,0,0,0,0,0,0,0,0,0,0,0,0,12,12,12,0,0,0,0,0,0,0,0,0,0,0,0,0,0,12,12,0,0,0,0,0,0,0,12,0,0,0,0,0,0,0,0,0,0,0,0,0,0,0,0,0,0,0,0,0,0,0,0,0,0
12,12,11,10,9,7,6,5,6,10,12,12,12,10,9,8,8,9,8,6,5,0,0,0,0,0,0,0,0,0,0,0,0,0,0,0,0,0,0,0,0,0,0,0,0,0,0,0,0,0,0,0,0,0,0,0,0,0,0,0,0,0,0,0,0,0,0,0,0,0,12,12,12,0,0,0,12,12,12,0,0,0,0,0,0,0,0,0,0,0,0,0,12,12,12,0,0,0,0,0,0,0,0,0,0,0,0,0,0,0,0,0,0,0,0,0,0,0,0,0,0,0,0,0,0,0,0,0
12,12,12,11,10,8,4,2,3,7,10,11,10,9,7,8,9,9,8,6,5,0,0,0,0,0,0,0,0,0,0,0,0,0,0,0,0,0,0,0,0,0,0,0,0,0,0,0,0,0,0,0,0,0,0,0,0,0,0,0,0,0,0,0,0,0,0,0,0,0,0,12,12,12,0,0,12,12,12,0,0,0,0,0,0,0,0,0,0,0,12,12,12,12,12,0,0,0,0,0,0,0,0,0,0,0,0,0,0,0,0,0,0,0,0,0,0,0,0,0,0,0,0,0,0,0,0,0
12,12,12,12,11,9,6,2,2,5,7,9,9,8,7,9,9,9,8,7,0,0,0,0,0,0,0,0,0,0,0,0,0,0,0,0,0,0,0,0,0,0,0,0,0,0,0,0,0,0,0,0,0,0,0,0,0,0,0,0,0,0,0,0,0,0,0,0,0,0,0,0,12,12,12,0,0,12,12,0,0,0,0,0,0,0,0,0,0,12,12,12,12,12,0,0,0,0,0,0,0,0,0,0,0,0,0,0,0,0,0,0,0,0,0,0,0,0,0,0,0,0,0,0,0,0,0,0
12,12,12,12,12,11,9,5,3,6,7,8,7,7,8,9,9,8,8,0,0,0,0,0,0,0,0,0,0,0,0,0,0,0,0,0,0,0,0,0,0,0,0,0,0,0,0,0,0,0,0,0,0,0,0,0,0,0,0,0,0,0,0,0,0,0,0,0,0,0,0,0,0,12,12,12,0,12,12,12,0,0,0,0,0,0,0,12,12,12,12,12,12,12,0,0,0,0,0,0,0,0,0,0,0,0,0,0,0,0,0,0,0,0,0,0,0,0,0,0,0,0,0,0,0,0,0,0
12,12,12,12,12,11,10,9,6,9,7,6,4,5,7,7,6,5,0,0,0,0,0,0,0,0,0,0,0,0,0,0,0,0,0,0,0,0,0,0,0,0,0,0,0,0,0,0,0,0,0,0,0,0,0,0,0,0,0,0,0,0,0,0,0,0,0,0,0,0,0,0,0,0,12,12,12,0,0,12,0,0,0,0,0,12,12,12,12,12,12,12,12,12,11,0,0,0,0,0,0,11,0,0,12,11,0,0,0,0,0,0,0,0,0,0,0,0,0,0,0,0,0,0,0,0,0,0
11,11,12,12,11,11,11,10,7,11,10,7,4,4,5,5,0,0,0,0,0,0,0,0,0,0,0,0,0,0,0,0,0,0,0,0,0,0,0,0,0,0,0,0,0,0,0,0,0,0,0,0,0,0,0,0,0,0,0,0,0,0,0,0,0,0,0,0,0,0,0,0,0,0,12,12,12,12,12,0,0,0,0,0,0,12,12,12,12,12,12,12,12,11,0,0,11,11,11,11,11,0,0,0,11,0,0,0,0,0,0,0,0,0,0,0,0,0,0,0,0,0,0,0,0,0,0,0
11,11,11,11,0,0,10,10,9,11,9,7,4,4,4,0,0,0,0,0,0,0,0,0,0,0,0,0,0,0,0,0,0,0,0,0,0,0,0,0,0,0,0,0,0,0,0,0,0,0,0,0,0,0,0,0,0,0,0,0,0,0,0,0,0,0,0,0,0,0,0,0,0,0,0,12,12,12,12,0,0,0,0,0,0,12,12,12,12,12,12,12,12,11,0,0,11,0,0,0,0,0,0,0,11,0,0,0,0,0,0,0,0,0,0,0,0,0,0,0,0,0,0,0,0,0,0,0
